XXXXXXXX
XXX...XX
X...X.XX
X.XMJG.X
X....X.X
XX.X...X
XX.J.XXX
XXXXXXXX

