XXXXXXXX
XXX.G.XX
X...X.XX
XJ...G.X
XJ...X.X
X..X...X
XXM..XXX
XXXXXXXX

