XXXXXXXX
XXX...XX
X.J.X.XX
X.X..G.X
X....X.X
XX.X...X
XXM..XXX
XXXXXXXX

