XXXXXXXX
XXX...XX
X.J.X.XX
X.X..G.X
X.G..X.X
XXJXGJ.X
XXM..XXX
XXXXXXXX

